B,B,B,B,B,B,B
B,B,B,B,B,B,B
B,B,B,B,B,B,B
B,B,B,B,B,B,B
A,b,c,C,b,c,d
A,f,g,A,f,g,h
A,B,B,A,B,B,A
A,B,B,A,B,B,A
A,B,B,A,B,B,A
A,B,B,A,B,B,A
B,B,B,B,B,B,B
B,B,B,B,B,B,B