B,B,B,B,B,B
B,B,B,B,B,B
B,B,B,B,B,B
J,r,B,B,q,I
A,t,r,q,s,A
A,v,t,s,u,A
A,B,v,u,B,A
A,B,B,B,B,A
A,B,B,B,B,A
A,B,B,B,B,A
B,B,B,B,B,B
B,B,B,B,B,B