B,B,B,B,B
B,B,B,B,B
B,B,B,B,B
J,r,B,B,A
A,t,r,B,A
A,v,t,r,A
A,B,v,t,A
A,B,B,v,A
A,B,B,B,A
A,B,B,B,A
B,B,B,B,B
B,B,B,B,B