B,B,B,B,B
B,B,B,B,B
B,B,B,B,B
a,b,A,B,B
e,f,B,B,B
i,j,B,A,B
G,A,A,A,A
e,f,B,A,B
i,j,q,D,j
m,n,o,m,n
B,B,B,B,B
B,B,B,B,B