B,B,B,B,B
B,B,B,B,B
B,B,B,B,B
B,B,B,B,B
A,B,B,A,B
A,B,B,A,B
A,B,B,A,B
A,B,B,A,B
i,j,k,A,j
m,n,o,D,n
B,B,B,B,B
B,B,B,B,B