B,B,B,B,B,B,B
B,B,B,B,B,B,B
B,B,B,B,B,B,B
A,B,B,A,B,B,A
A,B,B,A,B,B,A
A,B,B,A,B,B,A
A,B,B,A,B,B,A
A,B,B,A,B,B,A
K,r,q,A,r,q,L
v,t,s,z,t,s,u
B,B,B,B,B,B,B
B,B,B,B,B,B,B