B,B,B,B,B
B,B,B,B,B
B,B,B,B,B
t,r,B,q,s
v,t,w,s,u
B,v,A,u,B
B,q,A,r,B
q,s,z,t,r
I,u,B,v,J
A,B,B,B,A
B,B,B,B,B
B,B,B,B,B