B,B,B,B,B
B,B,B,B,B
B,B,B,B,B
A,B,B,B,A
t,r,B,q,s
v,t,w,s,u
B,x,A,y,B
q,s,z,t,r
I,u,B,v,J
A,B,B,B,A
B,B,B,B,B
B,B,B,B,B