B,B,B,B,B
B,B,B,B,B
B,B,B,B,B
A,B,B,B,A
K,r,B,q,L
v,t,w,s,u
B,v,A,u,B
B,B,A,B,B
B,B,A,B,B
B,B,A,B,B
B,B,B,B,B
B,B,B,B,B